WWWWWWWWWWWWWWWWWW
WSPPWWWWPPPPPPWWPW
WWWPWWWWWPWWWPWWPW
WPPPPPPWWPWWWPWWPW
WPWWWWPWWPPPWPWWPW
WPWWWWPWWWWPWPWWPW
WPPPPPPPPWWPWPWWPW
WWWPWWWWPWWPWPPPPW
WWWPWWWWPPPPWPWWPW
APPPWWWWPPWWWPWWPW
WWWWWWWWWPWWWPWWPW
WPPWPPPWWPWPWPWWPW
WPWWPWPWWPWPWPWWPW
WPPPPWPPPPWPPPWWPW
WPWWWWWWWWWWWWWWWW
WPWWPPPWPPPWPPPWPW
WPPPPWPPPWPPPWPPPW
WWWWWWWWWWWWWWWWWW
