010000000000000
022200002222200
000200000200000
000222200200000
000000200222000
000000200002000
000222222002000
000200002002000
000200002222200
222200000020000
000000002222200
002222222002000
002000002222000
322000002200000
000000000000000

