WWWPWWWWWWWWWWW
WSPPWWWWPPPPPPW
WWWPWWWWWPWWWPW
WPPPPPPWWPWWWPW
WPWWWWPWWPPPWPW
WPWWWWPWWWWPWPW
WPPPPPPPPWWPWPP
WWWPWWWWPWWPWPW
WWWPWWWWPPPPWPW
APPPWWWWPPWWWPW
WWWWWWWWWPWWWPW
WPPWPPPWWPWPWPW
WPWWPWPWWPWPWPW
WPPPPWPPPPWPPPW
WWWWWWPWWWWWWWW

