WSWWWWWWWWWWWWW
WPPPWWWWPPPPPPW
WWWPWWWWWPWWWPW
WPPPPPPWWPWWWPW
WPWWWWPWWPPPWPW
WPWWWWPWWWWPWPW
WPPPPPPPPWWPWPW
WWWPWWWWPWWPWPW
WWWPWWWWPPPPWPW
APPWWWWWPPWWWPW
WWWWWWWWWPPPPPW
WWWWWWWWWPPPPPW

