WSWWWWWWWWWWWWW
WPPPWWWWPPPPPPW
WWWPWWWWWPWWWPW
WPPPPPPWWPWWWPW
WPWWWWPWWPPPWPW
WPWWWWPWWWWPWPW
WPPPPPPPPWWPWPW
WWWPWWWWPWWPWPW
WWWPWWWWPPPPWPW
PPPPWWWWWWWWWPW
WWWWWWWWPPPPWPW
WWPPPPPPPWWPWPW
WWPWWWWWPPPPWPW
APPWWWWWPPWWWPW
WWWWWWWWWPPPPPW
