WSWWWWWWWWWWWWW
WPPPWWWWPPPPPWW
WWWPWWWWWPWWWWW
WWWPPPPWWPWWWWW
WWWWWWPWWPPPWWW
WWWWWWPWWWWPWWW
WWWPPPPPPWWPWWW
WWWPWWWWPWWPWWW
WWWPWWWWPPPPPWW
PPPPWWWWWWPWWWW
WWWWWWWWPPPPPWW
WWPPPPPPPWWPWWW
WWPWWWWWPPPPWWW
APPWWWWWPPWWWWW
WWWWWWWWWWWWWWW

