WSWWWWWWWWWWWWW
WPPPWWWWPPPPPPW
WWWPWWWWWPWWWPW
WPPPPPPWWPWWWPW
WPWWWWPWWPPPWPW
WPWWWWPWWWWPWPW
WPPPPPPPPWWPWPW
WWWPWWWWPWWPWPW
WWWPWWWWPPPPWPW
APPPWWWWPPWWWPW
WWWWWWWWWPWWWPW
WPPWPPPWWPWPWPW
WPWWPWPWWPWPWPW
WPPPPWPPPPWPPPWWWWWW
WWWWWWWWWWWWWWW
WWW
WWWWWW
